# # # # # # # # # # # # # # # # #
# . * . # . . . ~ # . . * . . . #
# # # # . # # # . # . # # . # . #
# * . . ~ # . # . ~ ~ . . . # * #
# # # . . # # . # . # . # . # . #
# . * . # ~ # . . . # # ~ # . . #
# # . # # . # # # . # . . . . . #
# . # . ~ * . . . # # . . # # . #
# . * . . . # . # . . # . ~ * * #
# # # # # # . # . ~ . . # # . . #
# . * . . ~ # . . . # . * . . # #
# # . # # . # ~ # # # # . . ~ * #
# * . . . . # # . # . . . . . . #
# # # # # # # # # # # # # # # # #
