# # # # # # # # # # # # #
# * . * . # . * # # . ~ #
# * # . . # # . . # . # #
# . . . # . ~ . # . . ~ #
# # . # . ~ # * . # . . #
# ~ # # . . . . ~ . * # #
# . . # . # # . # . # . #
# . # . . . . . # . . . #
# . . . # . . . # . . . #
. . . . . . . . # . . . .
# # # # # # # # # # # # #